       C 87, 34, 140
           

NO      ./textures/brick.xpm        
SO ./textures/wood.xpm

EA  ./textures/stone.xpm    
WE      ./textures/metal.xpm     

F       70,     11, 03



1111111111111111111111111111111111
1000000000000000000000000000000001
1000000000000000000000000000000001
10E0000000000000000000000000000001
1000000000000000000000000000000001
1000000000000000000000000000000001
1000000000000000000000000000000001
1000000000000000000000000000000001
100000000000000000000000000000000111111111111
111111111111111110000000000000000000000000001
                10000000000000000000000000001
                10000000000000000000000000001
                10000000000000000000000000001
                10000000000000000000000000001
                10000000000000000000000000001
                10000000000000000000000000001
                10000000000000000000000000001
                10000000000000000000000000001
111111111111111110000000000000000000000000001
100000000000000000000000000000010111111111111
100000000000000000000000000000001
100000000000000000000000000000001
100000000000000000000000000000001
100000000000000000000000000000001
100000000000000000000000000000001
100000000000000000000000000000001
100000000000000000000000000000001
111111111111111111111111111111111