       C 40, 80, 150
           

NO      ./textures/konoha.xpm        
SO ./textures/eye.xpm

EA  ./textures/cloud.xpm    
WE      ./textures/shuriken.xpm     

F       40,     40, 40



1111111111111111111111111111111111111111111111111111111111111111111111111111111
1S10000001000000000000000000000001111111111000000000000000000000000000000000001
1010000001000000000000000000000001111111111010000000000000000000000000000000001
1010001001000000000000000000000001110001111010000000000000000000000000000000001
1010000001000000000000000000000001110101111010000000000000000000000000000000001
1010000001000000000000000000000001110101111010000000000000000000000000000000001
10100000010000000000000000000000011101011110100000000000001111100000000000000001
10100000010000000000000000000000011101000000100000000000001   100000000000000001
1000010000000000000000000000000001110111111110000000000000111110000000000000001
1011111111111111100000000000000000100100000010000000000000000000000000000000001
1011111111111111110000000000000001001000000010000000000000000000000000000000001
1011111111111110001000000000000110010000000010000000000000000000000000000000001
1011111111111110100100000000001000100000000010000000000000000000000000000000001
1011111111111110100010000000000100000000000010000000000000000000000000000000001
1011111111111110100001000000000101000000000010000000000000000000000000000000001
1011111111111110100000100000000101000000000010000000000000000000000000000000001
1011111111111110100000010000000101000000000010000000000000000000000000000000001
1000000000000000100000001000000000000000000010000000000000000000000000000000001
1111111111111111100000000100000000000000000010000000000000000000000000000000001
1000000000000000000100000010000101111111111110000000000000000000000000000000001
1000000000000010000000000001000010000000000000000000000000000000000000000000001
1000000000000000000000100000100010000000000000000000000000000000000000000000001
1000000100000000000000000000010010000000000000000000000000000000000000000000001
1000000000000000000001000000001010000000000000000000000000000000000000000000001
1000000000000000000000001000000010000000000000000000000000000000000000000000001
1000000000100000000000000000000010000000000000000000000000000000000000000000001
1000000000000000000000000000000010000000000000000000000000000000000000000000001
1000000000000000000000000000000010000000000000000000000000000000000000000000001
1000000000000000000000000000000010000000000000000000000000000000000000000000001
1000000010000000000000000000000010000000000000000000000000000000000000000000001
1000000000000000000000000000000010000000000000000000000000000000000000000000001
1000000000000000000000000000000011111111111111111111111111111111111111111111001
1000000000000010000000000000000000000000000000000000000000000000000000000000001
1000000000000000000000000000000000000000000000000000000000000000000000000000001
1111111111111111111111111111111111111111111111111111111111111111111111111111111